###                 #########
#   ############ #######B#  #
# ####                    # #
# ################### ##### #
#                     # #   #
##################### # # # #
#   ##                # # # #
# # ## ### ## ######### # # #
# #    #   ##           # # #
# # ## ################ # # #
### ##             #### # # #
### ############## ## # # # #
###             ##    # # # #
###### ######## ####### # # #
###### ####       ####      #
A           #################
#############################
