#################################
# A        #                    #
# ####### # ##### # ####### # # #
# #     # #     # #     # # # # #
# # ### # ##### # ### # # # # # #
# # #   #     # #   # # # # # # #
# # # ### ##### # ### # # # # # #
# # #       #     # #   # # # # #
# ##### ##### ##### # ##### # # #
# #     #         #         # # #
# ### ### ####### ######### ### #
# #           # #       #     # #
# ##### ####### # ##### # ##### #
# #       #     #     #       # #
# ####### # ##### ##### ####### #
#         #         #         #B#
#################################
